8 8
 *   
 * *** *
 * *
 * *****
 * *   *
 * * * *
 * * * *
     * *